╔═════════════╗
║           * ║
║     *     * ║
║     *     * ║
║           * ║
║ *         * ║
║           * ║
║      $    * ║
║   *       * ║
╚═════════════╝

